//MAP CONVERTED BY dmm2tgm.py THIS HEADER COMMENT PREVENTS RECONVERSION, DO NOT REMOVE
"a" = (
/turf/open/indestructible{
	icon = null;
	icon_state = null
	},
/area/space)
"b" = (
/turf/cordon,
/area/space)
"p" = (
/obj/effect/landmark{
	name = "Memento Mortem Exit"
	},
/turf/cordon,
/area/space)
"R" = (
/obj/effect/landmark{
	name = "Memento Mortem"
	},
/turf/open/indestructible{
	icon = null;
	icon_state = null
	},
/area/space)

(1,1,1) = {"
b
b
b
b
b
b
b
b
b
b
b
b
b
b
b
b
b
"}
(2,1,1) = {"
b
a
a
a
a
a
a
a
a
a
a
a
a
a
a
a
b
"}
(3,1,1) = {"
b
a
a
a
a
a
a
a
a
a
a
a
a
a
a
a
b
"}
(4,1,1) = {"
b
a
a
a
a
a
a
a
a
a
a
a
a
a
a
a
b
"}
(5,1,1) = {"
b
a
a
a
a
a
a
a
a
a
a
a
a
a
a
a
b
"}
(6,1,1) = {"
b
a
a
a
a
a
a
a
a
a
a
a
a
a
a
a
b
"}
(7,1,1) = {"
b
a
a
a
a
a
a
a
a
a
a
a
a
a
a
a
b
"}
(8,1,1) = {"
b
a
a
a
a
a
a
a
a
a
a
a
a
a
a
a
b
"}
(9,1,1) = {"
p
a
a
a
a
a
a
a
R
a
a
a
a
a
a
a
b
"}
(10,1,1) = {"
b
a
a
a
a
a
a
a
a
a
a
a
a
a
a
a
b
"}
(11,1,1) = {"
b
a
a
a
a
a
a
a
a
a
a
a
a
a
a
a
b
"}
(12,1,1) = {"
b
a
a
a
a
a
a
a
a
a
a
a
a
a
a
a
b
"}
(13,1,1) = {"
b
a
a
a
a
a
a
a
a
a
a
a
a
a
a
a
b
"}
(14,1,1) = {"
b
a
a
a
a
a
a
a
a
a
a
a
a
a
a
a
b
"}
(15,1,1) = {"
b
a
a
a
a
a
a
a
a
a
a
a
a
a
a
a
b
"}
(16,1,1) = {"
b
a
a
a
a
a
a
a
a
a
a
a
a
a
a
a
b
"}
(17,1,1) = {"
b
b
b
b
b
b
b
b
b
b
b
b
b
b
b
b
b
"}
