//MAP CONVERTED BY dmm2tgm.py THIS HEADER COMMENT PREVENTS RECONVERSION, DO NOT REMOVE
"a" = (
/turf/open/floor/iron,
/area/shuttle)
"l" = (
/obj/effect/landmark{
	name = "Ottoman Portal Entrance"
	},
/turf/open/floor/iron,
/area/shuttle)
"q" = (
/turf/closed/wall/mineral/titanium,
/area/shuttle)
"B" = (
/obj/effect/landmark{
	name = "Ottoman Portal Exit"
	},
/turf/open/floor/iron,
/area/shuttle)
"O" = (
/obj/item/banner/red,
/turf/open/floor/iron,
/area/shuttle)
"P" = (
/obj/effect/landmark{
	name = "Janissary Maker"
	},
/turf/open/floor/iron,
/area/shuttle)
"S" = (
/obj/effect/landmark/start{
	name = "Ottoman Raider"
	},
/turf/open/floor/iron,
/area/shuttle)

(1,1,1) = {"
q
q
q
q
q
q
q
q
q
q
q
q
q
q
q
q
q
q
q
q
q
q
q
q
q
q
q
q
q
q
"}
(2,1,1) = {"
q
a
a
a
a
a
a
a
a
a
a
a
a
a
a
a
a
a
a
a
a
a
a
a
a
a
a
a
a
q
"}
(3,1,1) = {"
q
a
a
a
a
a
a
a
a
a
a
a
a
a
a
a
a
a
a
a
a
a
a
a
a
a
a
a
a
q
"}
(4,1,1) = {"
q
a
a
a
a
a
a
a
a
a
a
a
a
a
a
a
O
O
O
O
a
a
a
a
a
a
a
a
a
q
"}
(5,1,1) = {"
q
a
a
a
a
a
a
a
a
a
a
a
a
a
a
a
O
O
O
O
a
a
a
a
a
a
a
a
a
q
"}
(6,1,1) = {"
q
a
a
a
a
a
a
a
a
a
a
a
a
a
a
a
O
O
O
O
a
a
a
a
a
a
a
a
a
q
"}
(7,1,1) = {"
q
a
a
a
a
a
a
a
a
a
a
a
a
a
a
a
a
a
a
a
a
a
a
a
a
a
a
a
a
q
"}
(8,1,1) = {"
q
a
a
a
a
a
a
a
a
a
a
a
a
a
a
a
a
a
a
a
a
a
a
a
a
a
a
a
a
q
"}
(9,1,1) = {"
q
a
a
a
a
a
a
O
a
a
a
a
a
a
a
a
l
a
a
a
a
a
a
a
a
a
a
a
a
q
"}
(10,1,1) = {"
q
a
a
a
a
a
a
a
a
a
a
a
a
a
a
a
a
a
a
a
a
a
a
a
a
a
a
a
a
q
"}
(11,1,1) = {"
q
a
a
a
a
a
a
a
a
a
a
a
a
a
a
a
P
a
a
a
a
a
a
a
a
a
a
a
a
q
"}
(12,1,1) = {"
q
a
a
a
a
a
a
a
a
a
a
a
a
a
a
a
a
a
a
a
a
a
a
a
a
a
a
a
a
q
"}
(13,1,1) = {"
q
a
a
a
a
a
a
a
a
a
a
S
a
a
a
a
B
a
a
a
a
a
a
a
a
a
a
a
a
q
"}
(14,1,1) = {"
q
a
a
a
a
a
a
a
a
a
a
S
a
a
a
a
a
a
a
a
a
a
a
a
a
a
a
a
a
q
"}
(15,1,1) = {"
q
a
a
a
a
a
a
a
a
a
a
S
a
a
a
O
a
a
a
a
a
a
a
a
a
a
a
a
a
q
"}
(16,1,1) = {"
q
a
a
a
a
a
a
a
a
a
a
S
a
a
a
a
a
a
a
a
a
a
a
a
a
a
a
a
a
q
"}
(17,1,1) = {"
q
a
a
a
a
a
a
a
a
a
a
S
a
a
a
a
a
a
a
a
a
a
O
a
a
a
a
a
a
q
"}
(18,1,1) = {"
q
a
a
a
a
a
a
a
a
a
a
a
a
a
a
a
a
a
a
a
a
a
a
a
a
a
a
a
a
q
"}
(19,1,1) = {"
q
a
a
a
a
a
a
a
a
a
a
a
a
a
a
a
a
a
a
a
a
a
a
a
a
a
a
a
a
q
"}
(20,1,1) = {"
q
a
a
a
a
a
O
a
a
a
a
a
a
a
a
a
a
a
a
a
a
a
a
a
a
a
a
a
a
q
"}
(21,1,1) = {"
q
a
a
a
a
a
O
a
a
a
a
O
a
a
a
a
a
a
a
a
a
a
a
a
a
a
a
a
a
q
"}
(22,1,1) = {"
q
a
a
a
a
a
a
a
a
a
a
a
a
a
a
a
a
a
a
a
a
a
a
a
a
a
a
a
a
q
"}
(23,1,1) = {"
q
a
a
a
a
a
a
a
a
a
a
a
a
a
a
a
a
a
a
a
a
a
a
O
a
a
a
a
a
q
"}
(24,1,1) = {"
q
a
a
a
a
a
a
a
a
a
a
a
a
a
a
a
a
a
a
a
a
a
a
a
a
a
a
a
a
q
"}
(25,1,1) = {"
q
a
a
a
a
a
a
a
a
a
a
a
a
a
a
a
a
a
a
a
a
a
a
a
a
a
a
a
a
q
"}
(26,1,1) = {"
q
a
a
a
a
a
a
a
a
a
a
a
a
a
a
a
a
a
a
a
a
a
a
a
a
a
a
a
a
q
"}
(27,1,1) = {"
q
a
a
a
a
a
a
a
a
a
a
a
a
a
a
a
a
a
a
a
a
a
a
a
a
a
a
a
a
q
"}
(28,1,1) = {"
q
a
a
a
a
a
a
a
a
a
a
a
a
a
a
a
a
a
a
a
a
a
a
a
a
a
a
a
a
q
"}
(29,1,1) = {"
q
a
a
a
a
a
a
a
a
a
a
a
a
a
a
a
a
a
a
a
a
a
a
a
a
a
a
a
a
q
"}
(30,1,1) = {"
q
q
q
q
q
q
q
q
q
q
q
q
q
q
q
q
q
q
q
q
q
q
q
q
q
q
q
q
q
q
"}
