//MAP CONVERTED BY dmm2tgm.py THIS HEADER COMMENT PREVENTS RECONVERSION, DO NOT REMOVE
"a" = (
/turf/open/floor/iron,
/area/shuttle)
"j" = (
/turf/closed/wall/mineral/titanium,
/area/shuttle)
"H" = (
/obj/effect/landmark/start{
	name = "Ottoman Raider"
	},
/turf/open/floor/iron,
/area/shuttle)
"N" = (
/obj/item/banner/red,
/turf/open/floor/iron,
/area/shuttle)

(1,1,1) = {"
j
j
j
j
j
j
j
j
j
j
j
j
j
j
j
j
j
j
j
j
j
j
j
j
j
j
j
j
j
j
"}
(2,1,1) = {"
j
a
a
a
a
a
a
a
a
a
a
a
a
a
a
a
a
a
a
a
a
a
a
a
a
a
a
a
a
j
"}
(3,1,1) = {"
j
a
a
a
a
a
a
a
a
a
a
a
a
a
a
a
a
a
a
a
a
a
a
a
a
a
a
a
a
j
"}
(4,1,1) = {"
j
a
a
a
a
a
a
a
a
a
a
a
a
a
a
a
N
N
N
N
a
a
a
a
a
a
a
a
a
j
"}
(5,1,1) = {"
j
a
a
a
a
a
a
a
a
a
a
a
a
a
a
a
N
N
N
N
a
a
a
a
a
a
a
a
a
j
"}
(6,1,1) = {"
j
a
a
a
a
a
a
a
a
a
a
a
a
a
a
a
N
N
N
N
a
a
a
a
a
a
a
a
a
j
"}
(7,1,1) = {"
j
a
a
a
a
a
a
a
a
a
a
a
a
a
a
a
a
a
a
a
a
a
a
a
a
a
a
a
a
j
"}
(8,1,1) = {"
j
a
a
a
a
a
a
a
a
a
a
a
a
a
a
a
a
a
a
a
a
a
a
a
a
a
a
a
a
j
"}
(9,1,1) = {"
j
a
a
a
a
a
a
N
a
a
a
a
a
a
a
a
a
a
a
a
a
a
a
a
a
a
a
a
a
j
"}
(10,1,1) = {"
j
a
a
a
a
a
a
a
a
a
a
a
a
a
a
a
a
a
a
a
a
a
a
a
a
a
a
a
a
j
"}
(11,1,1) = {"
j
a
a
a
a
a
a
a
a
a
a
a
a
a
a
a
a
a
a
a
a
a
a
a
a
a
a
a
a
j
"}
(12,1,1) = {"
j
a
a
a
a
a
a
a
a
a
a
a
a
a
a
a
a
a
a
a
a
a
a
a
a
a
a
a
a
j
"}
(13,1,1) = {"
j
a
a
a
a
a
a
a
a
a
a
H
a
a
a
a
a
a
a
a
a
a
a
a
a
a
a
a
a
j
"}
(14,1,1) = {"
j
a
a
a
a
a
a
a
a
a
a
H
a
a
a
a
a
a
a
a
a
a
a
a
a
a
a
a
a
j
"}
(15,1,1) = {"
j
a
a
a
a
a
a
a
a
a
a
H
a
a
a
N
a
a
a
a
a
a
a
a
a
a
a
a
a
j
"}
(16,1,1) = {"
j
a
a
a
a
a
a
a
a
a
a
H
a
a
a
a
a
a
a
a
a
a
a
a
a
a
a
a
a
j
"}
(17,1,1) = {"
j
a
a
a
a
a
a
a
a
a
a
H
a
a
a
a
a
a
a
a
a
a
N
a
a
a
a
a
a
j
"}
(18,1,1) = {"
j
a
a
a
a
a
a
a
a
a
a
a
a
a
a
a
a
a
a
a
a
a
a
a
a
a
a
a
a
j
"}
(19,1,1) = {"
j
a
a
a
a
a
a
a
a
a
a
a
a
a
a
a
a
a
a
a
a
a
a
a
a
a
a
a
a
j
"}
(20,1,1) = {"
j
a
a
a
a
a
N
a
a
a
a
a
a
a
a
a
a
a
a
a
a
a
a
a
a
a
a
a
a
j
"}
(21,1,1) = {"
j
a
a
a
a
a
N
a
a
a
a
N
a
a
a
a
a
a
a
a
a
a
a
a
a
a
a
a
a
j
"}
(22,1,1) = {"
j
a
a
a
a
a
a
a
a
a
a
a
a
a
a
a
a
a
a
a
a
a
a
a
a
a
a
a
a
j
"}
(23,1,1) = {"
j
a
a
a
a
a
a
a
a
a
a
a
a
a
a
a
a
a
a
a
a
a
a
N
a
a
a
a
a
j
"}
(24,1,1) = {"
j
a
a
a
a
a
a
a
a
a
a
a
a
a
a
a
a
a
a
a
a
a
a
a
a
a
a
a
a
j
"}
(25,1,1) = {"
j
a
a
a
a
a
a
a
a
a
a
a
a
a
a
a
a
a
a
a
a
a
a
a
a
a
a
a
a
j
"}
(26,1,1) = {"
j
a
a
a
a
a
a
a
a
a
a
a
a
a
a
a
a
a
a
a
a
a
a
a
a
a
a
a
a
j
"}
(27,1,1) = {"
j
a
a
a
a
a
a
a
a
a
a
a
a
a
a
a
a
a
a
a
a
a
a
a
a
a
a
a
a
j
"}
(28,1,1) = {"
j
a
a
a
a
a
a
a
a
a
a
a
a
a
a
a
a
a
a
a
a
a
a
a
a
a
a
a
a
j
"}
(29,1,1) = {"
j
a
a
a
a
a
a
a
a
a
a
a
a
a
a
a
a
a
a
a
a
a
a
a
a
a
a
a
a
j
"}
(30,1,1) = {"
j
j
j
j
j
j
j
j
j
j
j
j
j
j
j
j
j
j
j
j
j
j
j
j
j
j
j
j
j
j
"}
