//MAP CONVERTED BY dmm2tgm.py THIS HEADER COMMENT PREVENTS RECONVERSION, DO NOT REMOVE
"a" = (
/turf/open/floor/iron,
/area/shuttle)
"k" = (
/turf/closed/wall/mineral/titanium,
/area/shuttle)
"r" = (
/obj/item/banner/red,
/turf/open/floor/iron,
/area/shuttle)

(1,1,1) = {"
k
k
k
k
k
k
k
k
k
k
k
k
k
k
k
k
k
k
k
k
k
k
k
k
k
k
k
k
k
k
"}
(2,1,1) = {"
k
a
a
a
a
a
a
a
a
a
a
a
a
a
a
a
a
a
a
a
a
a
a
a
a
a
a
a
a
k
"}
(3,1,1) = {"
k
a
a
a
a
a
a
a
a
a
a
a
a
a
a
a
a
a
a
a
a
a
a
a
a
a
a
a
a
k
"}
(4,1,1) = {"
k
a
a
a
a
a
a
a
a
a
a
a
a
a
a
a
r
r
r
r
a
a
a
a
a
a
a
a
a
k
"}
(5,1,1) = {"
k
a
a
a
a
a
a
a
a
a
a
a
a
a
a
a
r
r
r
r
a
a
a
a
a
a
a
a
a
k
"}
(6,1,1) = {"
k
a
a
a
a
a
a
a
a
a
a
a
a
a
a
a
r
r
r
r
a
a
a
a
a
a
a
a
a
k
"}
(7,1,1) = {"
k
a
a
a
a
a
a
a
a
a
a
a
a
a
a
a
a
a
a
a
a
a
a
a
a
a
a
a
a
k
"}
(8,1,1) = {"
k
a
a
a
a
a
a
a
a
a
a
a
a
a
a
a
a
a
a
a
a
a
a
a
a
a
a
a
a
k
"}
(9,1,1) = {"
k
a
a
a
a
a
a
r
a
a
a
a
a
a
a
a
a
a
a
a
a
a
a
a
a
a
a
a
a
k
"}
(10,1,1) = {"
k
a
a
a
a
a
a
a
a
a
a
a
a
a
a
a
a
a
a
a
a
a
a
a
a
a
a
a
a
k
"}
(11,1,1) = {"
k
a
a
a
a
a
a
a
a
a
a
a
a
a
a
a
a
a
a
a
a
a
a
a
a
a
a
a
a
k
"}
(12,1,1) = {"
k
a
a
a
a
a
a
a
a
a
a
a
a
a
a
a
a
a
a
a
a
a
a
a
a
a
a
a
a
k
"}
(13,1,1) = {"
k
a
a
a
a
a
a
a
a
a
a
a
a
a
a
a
a
a
a
a
a
a
a
a
a
a
a
a
a
k
"}
(14,1,1) = {"
k
a
a
a
a
a
a
a
a
a
a
a
a
a
a
a
a
a
a
a
a
a
a
a
a
a
a
a
a
k
"}
(15,1,1) = {"
k
a
a
a
a
a
a
a
a
a
a
a
a
a
a
r
a
a
a
a
a
a
a
a
a
a
a
a
a
k
"}
(16,1,1) = {"
k
a
a
a
a
a
a
a
a
a
a
a
a
a
a
a
a
a
a
a
a
a
a
a
a
a
a
a
a
k
"}
(17,1,1) = {"
k
a
a
a
a
a
a
a
a
a
a
a
a
a
a
a
a
a
a
a
a
a
r
a
a
a
a
a
a
k
"}
(18,1,1) = {"
k
a
a
a
a
a
a
a
a
a
a
a
a
a
a
a
a
a
a
a
a
a
a
a
a
a
a
a
a
k
"}
(19,1,1) = {"
k
a
a
a
a
a
a
a
a
a
a
a
a
a
a
a
a
a
a
a
a
a
a
a
a
a
a
a
a
k
"}
(20,1,1) = {"
k
a
a
a
a
a
r
a
a
a
a
a
a
a
a
a
a
a
a
a
a
a
a
a
a
a
a
a
a
k
"}
(21,1,1) = {"
k
a
a
a
a
a
r
a
a
a
a
r
a
a
a
a
a
a
a
a
a
a
a
a
a
a
a
a
a
k
"}
(22,1,1) = {"
k
a
a
a
a
a
a
a
a
a
a
a
a
a
a
a
a
a
a
a
a
a
a
a
a
a
a
a
a
k
"}
(23,1,1) = {"
k
a
a
a
a
a
a
a
a
a
a
a
a
a
a
a
a
a
a
a
a
a
a
r
a
a
a
a
a
k
"}
(24,1,1) = {"
k
a
a
a
a
a
a
a
a
a
a
a
a
a
a
a
a
a
a
a
a
a
a
a
a
a
a
a
a
k
"}
(25,1,1) = {"
k
a
a
a
a
a
a
a
a
a
a
a
a
a
a
a
a
a
a
a
a
a
a
a
a
a
a
a
a
k
"}
(26,1,1) = {"
k
a
a
a
a
a
a
a
a
a
a
a
a
a
a
a
a
a
a
a
a
a
a
a
a
a
a
a
a
k
"}
(27,1,1) = {"
k
a
a
a
a
a
a
a
a
a
a
a
a
a
a
a
a
a
a
a
a
a
a
a
a
a
a
a
a
k
"}
(28,1,1) = {"
k
a
a
a
a
a
a
a
a
a
a
a
a
a
a
a
a
a
a
a
a
a
a
a
a
a
a
a
a
k
"}
(29,1,1) = {"
k
a
a
a
a
a
a
a
a
a
a
a
a
a
a
a
a
a
a
a
a
a
a
a
a
a
a
a
a
k
"}
(30,1,1) = {"
k
k
k
k
k
k
k
k
k
k
k
k
k
k
k
k
k
k
k
k
k
k
k
k
k
k
k
k
k
k
"}
