//MAP CONVERTED BY dmm2tgm.py THIS HEADER COMMENT PREVENTS RECONVERSION, DO NOT REMOVE
"aA" = (
/obj/machinery/power/shuttle_engine/propulsion/burst/right,
/turf/open/floor/plating/airless,
/area/shuttle)
"dR" = (
/obj/structure/railing/corner/end/flip,
/turf/open/floor/mineral/plastitanium/red,
/area/shuttle)
"ei" = (
/obj/structure/reagent_dispensers/plumbed/fuel,
/turf/open/floor/plating/airless,
/area/shuttle)
"eK" = (
/obj/structure/table/wood/fancy/red,
/obj/machinery/coffeemaker/impressa{
	pixel_y = 5
	},
/turf/open/floor/carpet/red,
/area/shuttle)
"gm" = (
/obj/machinery/computer/shuttle{
	shuttleId = "ottoman";
	req_access = list("cent_captain");
	interaction_flags_machine = 0;
	possible_destinations = "ottoman_custom"
	},
/turf/open/floor/carpet/lone{
	dir = 4
	},
/area/shuttle)
"gp" = (
/obj/structure/railing{
	dir = 8
	},
/turf/open/floor/mineral/plastitanium/red,
/area/shuttle)
"in" = (
/obj/machinery/power/shuttle_engine/heater,
/obj/machinery/duct,
/obj/structure/window/reinforced/survival_pod/spawner/directional/north,
/turf/open/floor/plating/airless,
/area/shuttle)
"lj" = (
/turf/closed/wall/mineral/plastitanium,
/area/shuttle)
"lI" = (
/obj/structure/rack,
/obj/item/kitchen/fork{
	pixel_x = 7;
	pixel_y = 2
	},
/obj/item/kitchen/spoon{
	pixel_y = 2
	},
/obj/item/knife/kitchen{
	pixel_x = -6;
	pixel_y = 3
	},
/obj/item/assembly/signaler{
	frequency = 1449;
	pixel_x = 11;
	pixel_y = -1
	},
/turf/open/floor/mineral/silver,
/area/shuttle)
"ob" = (
/turf/open/floor/glass,
/area/shuttle)
"pd" = (
/turf/open/floor/mineral/silver,
/area/shuttle)
"pT" = (
/obj/structure/railing{
	dir = 8
	},
/obj/machinery/portable_atmospherics/canister/oxygen,
/turf/open/floor/mineral/plastitanium/red,
/area/shuttle)
"pW" = (
/obj/structure/railing/corner/end,
/turf/open/floor/mineral/plastitanium/red,
/area/shuttle)
"rL" = (
/turf/closed/wall/mineral/titanium,
/area/shuttle)
"sn" = (
/obj/machinery/door/poddoor/shutters{
	name = "Operation Shutters";
	id = "ottoman"
	},
/obj/structure/holosign/barrier/atmos/sturdy,
/turf/open/floor/mineral/plastitanium/red,
/area/shuttle)
"sG" = (
/turf/open/floor/iron/stairs/left,
/area/shuttle)
"ts" = (
/obj/structure/table/wood/fancy/red,
/obj/item/book/bible{
	name = "Quran";
	icon_state = "koran";
	inhand_icon_state = "koran";
	deity_name = "Allah";
	pixel_y = 7
	},
/turf/open/floor/carpet/red,
/area/shuttle)
"uQ" = (
/obj/machinery/computer/camera_advanced/syndie{
	dir = 8
	},
/turf/open/floor/carpet/red,
/area/shuttle)
"Ad" = (
/obj/structure/chair/e_chair{
	dir = 1
	},
/turf/open/floor/carpet/lone{
	dir = 4
	},
/area/shuttle)
"BF" = (
/obj/structure/closet/crate/freezer,
/obj/item/food/pie/baklava,
/obj/item/food/meat/steak/chicken,
/obj/item/food/fishmeat/fish_tail,
/obj/item/storage/box/coffeepack,
/obj/item/storage/box/coffeepack/robusta,
/turf/open/floor/mineral/silver,
/area/shuttle)
"BJ" = (
/obj/structure/statue/sandstone/venus{
	dir = 1
	},
/turf/open/floor/mineral/silver,
/area/shuttle)
"BX" = (
/turf/open/floor/iron/stairs/medium,
/area/shuttle)
"Em" = (
/obj/structure/railing{
	dir = 4
	},
/turf/open/floor/mineral/plastitanium/red,
/area/shuttle)
"Fr" = (
/obj/structure/statue/sandstone/venus,
/turf/open/floor/mineral/silver,
/area/shuttle)
"Gn" = (
/obj/structure/chair/bronze,
/obj/effect/landmark{
	name = "Ottoman Sultan"
	},
/turf/open/floor/carpet/red,
/area/shuttle)
"GA" = (
/obj/machinery/power/shuttle_engine/propulsion/burst,
/turf/open/floor/plating/airless,
/area/shuttle)
"HP" = (
/obj/structure/table/wood/fancy/red,
/obj/item/reagent_containers/cup/maunamug{
	pixel_x = 10;
	pixel_y = 10
	},
/turf/open/floor/carpet/red,
/area/shuttle)
"Id" = (
/turf/template_noop,
/area/template_noop)
"IA" = (
/obj/machinery/door/airlock/silver{
	name = "Sultan's Chamber";
	req_access = list("maint_tunnels")
	},
/turf/open/floor/mineral/silver,
/area/shuttle)
"JL" = (
/obj/item/radio/intercom/syndicate/freerange{
	name = "ottoman wide-band intercom";
	resistance_flags = 115;
	icon_off = "bogdanoff";
	icon_state = "bogdanoff";
	icon = 'icons/obj/machines/money_machine.dmi';
	pixel_y = -1;
	desc = "A custom-made Ottoman-issue intercom used to transmit on all Nanotrasen frequencies. Particularly expensive.";
	density = 1
	},
/turf/open/floor/carpet/lone{
	dir = 4
	},
/area/shuttle)
"LW" = (
/mob/living/basic/pony{
	dir = 8;
	name = "Duldul";
	health = 300;
	maxHealth = 300;
	ponycolors = list("#d0cecc","#353841")
	},
/obj/machinery/door/window/survival_pod/left/directional/west{
	req_access = list("cent_captain")
	},
/turf/open/floor/carpet/lone{
	dir = 4
	},
/area/shuttle)
"PL" = (
/obj/machinery/door/window/survival_pod/left/directional/west{
	req_access = list("cent_captain");
	dir = 4
	},
/obj/structure/rack,
/obj/item/food/grown/apple/gold,
/obj/item/food/grown/apple/gold,
/obj/item/food/grown/apple/gold,
/obj/item/food/grown/apple/gold,
/obj/item/food/grown/apple/gold,
/obj/item/food/grown/apple/gold,
/obj/item/food/grown/apple/gold,
/obj/item/food/grown/apple/gold,
/obj/item/food/grown/apple/gold,
/obj/item/food/grown/apple/gold,
/obj/item/food/grown/apple/gold,
/obj/item/food/grown/apple/gold,
/obj/item/food/grown/apple/gold,
/obj/item/food/grown/apple/gold,
/turf/open/floor/carpet/lone{
	dir = 4
	},
/area/shuttle)
"PM" = (
/turf/closed/wall/mineral/titanium/nodiagonal,
/area/shuttle)
"PX" = (
/obj/machinery/telecomms/allinone/indestructible,
/turf/open/floor/carpet/lone{
	dir = 4
	},
/area/shuttle)
"Rm" = (
/turf/open/floor/mineral/plastitanium/red,
/area/shuttle)
"Rn" = (
/obj/effect/spawner/structure/window/reinforced/shuttle,
/turf/open/floor/glass,
/area/shuttle)
"Sk" = (
/obj/machinery/door/airlock/titanium/glass{
	name = "Sultan's Chamber"
	},
/turf/open/floor/glass,
/area/shuttle)
"VP" = (
/obj/structure/railing{
	dir = 4
	},
/obj/structure/tank_dispenser/oxygen,
/turf/open/floor/mineral/plastitanium/red,
/area/shuttle)
"Wb" = (
/turf/open/floor/iron/stairs/right,
/area/shuttle)
"Wv" = (
/obj/machinery/computer/camera_advanced/shuttle_docker{
	shuttleId = "ottoman";
	shuttlePortId = "ottoman_custom";
	jump_to_ports = list("whiteship_away" = 1);
	view_range = 10;
	dir = 4
	},
/turf/open/floor/carpet/red,
/area/shuttle)
"Ys" = (
/obj/machinery/power/shuttle_engine/propulsion/burst/left,
/turf/open/floor/plating/airless,
/area/shuttle)

(1,1,1) = {"
Id
Id
Id
Id
Id
Id
Id
rL
rL
rL
rL
rL
rL
rL
Id
Id
Id
Id
Id
Id
Id
Id
Id
"}
(2,1,1) = {"
Id
Id
Id
Id
rL
rL
rL
rL
Rm
Rm
Rm
Rm
Rm
rL
rL
rL
Id
Id
Id
Id
Id
Id
Id
"}
(3,1,1) = {"
Id
Id
Id
rL
rL
Rm
Rm
Rm
Rm
Rm
Rm
Rm
Rm
Rm
Rm
rL
rL
rL
Id
Id
Id
Id
Id
"}
(4,1,1) = {"
Id
Id
rL
rL
Rm
Rm
Rm
Rm
Rm
Rm
Rm
Rm
Rm
Rm
Rm
Rm
Rm
rL
PM
lj
lj
lj
lj
"}
(5,1,1) = {"
Id
rL
rL
Rm
Rm
Rm
Rm
rL
rL
rL
rL
rL
rL
Rm
Rm
Rm
Rm
Rm
PM
PM
ei
in
Ys
"}
(6,1,1) = {"
Id
rL
Rm
Rm
Rm
rL
rL
rL
Id
Id
Id
Id
rL
rL
rL
Rm
Rm
Rm
Rm
PM
PM
in
GA
"}
(7,1,1) = {"
rL
rL
Rm
Rm
rL
rL
Id
Id
Id
Id
Id
Id
Id
Id
rL
rL
Rm
Rm
Rm
Rm
PM
in
aA
"}
(8,1,1) = {"
rL
Rm
Rm
rL
rL
Id
Id
Id
rL
Id
Id
Id
Id
Id
Id
rL
rL
Rm
Rm
Rm
PM
PM
lj
"}
(9,1,1) = {"
rL
Rm
rL
rL
Id
Id
Id
Id
rL
rL
rL
Id
Id
Id
Id
Id
rL
Rm
Rm
Rm
Rm
rL
Id
"}
(10,1,1) = {"
rL
rL
rL
Id
Id
Id
Id
Id
rL
JL
rL
rL
rL
rL
rL
Id
rL
rL
Rm
Rm
Rm
rL
rL
"}
(11,1,1) = {"
Id
rL
rL
Id
Id
Id
Id
rL
rL
pd
Fr
rL
PL
rL
Id
Id
Id
rL
Rm
dR
Em
VP
rL
"}
(12,1,1) = {"
Id
Id
rL
Id
Id
Id
rL
rL
BF
Wv
HP
pd
pd
PM
Rn
Rn
Rn
rL
Rm
Rm
Rm
sG
sn
"}
(13,1,1) = {"
Id
Id
Id
Id
Id
rL
rL
gm
pd
Gn
ts
Ad
pd
IA
ob
ob
ob
Sk
Rm
Rm
Rm
BX
sn
"}
(14,1,1) = {"
Id
Id
rL
Id
Id
Id
rL
rL
lI
uQ
eK
pd
pd
PM
Rn
Rn
Rn
rL
Rm
Rm
Rm
Wb
sn
"}
(15,1,1) = {"
Id
rL
rL
Id
Id
Id
Id
rL
rL
pd
BJ
rL
LW
rL
Id
Id
Id
rL
Rm
pW
gp
pT
rL
"}
(16,1,1) = {"
rL
rL
rL
Id
Id
Id
Id
Id
rL
PX
rL
rL
rL
rL
rL
Id
rL
rL
Rm
Rm
Rm
rL
rL
"}
(17,1,1) = {"
rL
Rm
rL
rL
Id
Id
Id
Id
rL
rL
rL
Id
Id
Id
Id
Id
rL
Rm
Rm
Rm
Rm
rL
Id
"}
(18,1,1) = {"
rL
Rm
Rm
rL
rL
Id
Id
Id
rL
Id
Id
Id
Id
Id
Id
rL
rL
Rm
Rm
Rm
PM
PM
lj
"}
(19,1,1) = {"
rL
rL
Rm
Rm
rL
rL
Id
Id
Id
Id
Id
Id
Id
Id
rL
rL
Rm
Rm
Rm
Rm
PM
in
Ys
"}
(20,1,1) = {"
Id
rL
Rm
Rm
Rm
rL
rL
rL
Id
Id
Id
Id
rL
rL
rL
Rm
Rm
Rm
Rm
PM
PM
in
GA
"}
(21,1,1) = {"
Id
rL
rL
Rm
Rm
Rm
Rm
rL
rL
rL
rL
rL
rL
Rm
Rm
Rm
Rm
Rm
PM
PM
ei
in
aA
"}
(22,1,1) = {"
Id
Id
rL
rL
Rm
Rm
Rm
Rm
Rm
Rm
Rm
Rm
Rm
Rm
Rm
Rm
Rm
rL
PM
lj
lj
lj
lj
"}
(23,1,1) = {"
Id
Id
Id
rL
rL
Rm
Rm
Rm
Rm
Rm
Rm
Rm
Rm
Rm
Rm
rL
rL
rL
Id
Id
Id
Id
Id
"}
(24,1,1) = {"
Id
Id
Id
Id
rL
rL
rL
rL
Rm
Rm
Rm
Rm
Rm
rL
rL
rL
Id
Id
Id
Id
Id
Id
Id
"}
(25,1,1) = {"
Id
Id
Id
Id
Id
Id
Id
rL
rL
rL
rL
rL
rL
rL
Id
Id
Id
Id
Id
Id
Id
Id
Id
"}
